120
..##############...
..#11111M11111P#...
..######1#######...
.......#1#.........
.......#I1#........
.......#11#........
......#11#.........
......#11#.........
.......#1#.........
.......#1#.........
#######T1#########.
#W11111111111111T#.
########i#########.
.......###.........
...................