...................
...................
...................
...................
...................
...................
.........#########.
.........#1111111#.
.#########1#####1#.
.#P11111112111111#.
.#########1#######.
.........#1#.......
.........#W#.......
.........###.......
...................
