..##############...
..#11111M11111P#...
..######1#######...
.......#1#.........
.......#11#........
.......#11#........
......#11#.........
......#11#.........
.......#1#.........
.......#1#.........
########1#########.
#W111111211111111#.
########1#######1#.
.......#111111111#.
.......###########.