150
.......############
..###..#1111111111#
..#W#..#1########1#
###1#..#1#......#1#
#111#..#1#......#1#
#1###..#1#......#1#
#1#....#1#......#1#
#1#....#1#......#1#
#1#....#1#......#1#
#1#....#1#......#1#
#1######1########1#
#1T#11111111111P#1#
#1111####1#######1#
#111111111T1111111#
###################