40
...................
...................
.#######...........
.##P1##............
.###1#######.......
...#1111111#.......
..#####E##1#.......
..#11e11111########
..#11111111111111W#
..#################
...................
...................
...................
...................
...................
