...................
...................
...................
...................
...................
...................
...................
...................
.#################.
.#P1111111111111W#.
.#################.
...................
...................
...................
...................