...................
...................
...................
...................
...................
...................
..###........###...
..#W#........#P#...
..#1#####....#1#...
..#1##11######1#...
..#111111111111#...
..#11####11##11#...
..####..########...
...................
...................