150
.......############
..###..#1111111111#
..#W#..#1########1#
###1#..#1#......#1#
#111#..#1#......#H#
#1###..#1#......#2#
#1#....#1#......#3#
#1#....#1#......#4#
#1#....#1#......#5#
#1#....#1#......#6#
#1######1########7#
#1T#11111111111P#1#
#1111####1#######1#
#111111111T1111111#
###################
