60
...................
.#################.
.#################.
.#P1111111111111E#.
.#111111111111111#.
.#11111111e111111#.
.#111111111111111#.
.#1111111e1111111#.
.#111111111111111#.
.#111111e11111111#.
.#111111111111111#.
.#E1111111111111W#.
.#################.
.#################.
...................
